NO                        ./imgs/redbrick.xpm
11111111111111
10E00010000001
10000010000001111
10000000000000001
11111111111000001
          1000001
          1111111