1111111111111111111111111111111111111111
10000010000000000000000000000000000000E1
1000100010000000000000000000000000000001
1000101000000000000000000000000000000001
1000100010000000000000000000000000000001
1000100010000000000000000000000000000001
1000100010000000000000000000000000000001
1000100010000000000000000000000000000001
1000100010000000000000000000000000000001
1000100010000000000000000000000000000001
1000100010000000000000000000000000000001
1111111111111111111111111111111111111111