EA  imgs/redbrick.xpm
WE  imgs/bluestone.xpm
SO  imgs/eagle.xpm
NO  imgs/wall21.xpm
C   166,206,227
F   178,223,138
1111111111111111111111111111111111111111
10000010000000000000000000000000000000W1
1000100010000000000000000000000000000001
10P0101000000000000000000000000000000001
1111111111111111111111111111111111111111