EA  imgs/redbrick.xpm
WE  imgs/bluestone.xpm
SO  imgs/eagle.xpm
NO  imgs/wall21.xpm
C   166,206,227
F   178,223,138
11111111111111
100000100000S1
10001000100001
10001010000001
10001000100001
10001000100001
10001000100001
10001000100001
10001000100001
10001000100001
10001000100001
11111111111111