EA  imgs/redbrick.xpm
WE  imgs/bluestone.xpm
SO  imgs/eagle.xpm
NO  imgs/wall21.xpm
C   166,206,227
F   178,223,138
1111111111111111111111111111111111111111
10000010001011101110111011000000001000W1
1000100010000000000000001111101111101111
1000101000000000000000000000000000000001
1000100010011111001111101100011101101111
1000100010011111001111101100010001001001
1000100010010001001001000100010000001001
1000100010010001001001000100010010001001
1000100010010001001001000000000000001001
1000100010010001001001000000011111100001
1000100010000000000000000000000000101001
1111111111111111111111111111111111111111