NO  imgs/barrel.xpm
 11111111111111
 1101001000000111
  110000010000001
 1100100000011111
 1000000000E000011
 11111111111000001
          10000011
          1111111